-1
#############
#Aa.@.......@#
#a..........#
#..........b#
#@@.......bB#
#############
